

level 2
maze div 
    width:  2.8vmax; 
    height: 2.8vmax;

sonic 
x=13, y=13

enemy - cybermen maybe / weeping Angels
8,7
7,7
6,7
7,8
7,6
3,3
11,11

const gameBoard = [
    [0,0,0,0,0,0,0,0,0,0,0,0,0,0,0],
    [0,1,1,1,1,0,1,1,1,0,1,1,1,1,1],
    [0,1,0,0,1,0,1,0,1,0,1,0,0,1,0],
    [0,1,0,1,1,1,1,0,1,1,1,1,0,1,0],
    [0,1,1,1,0,0,1,1,1,0,0,1,1,1,0],
    [0,1,0,1,1,1,1,0,1,1,1,1,0,1,0],
    [0,1,1,1,0,1,0,1,0,1,0,1,1,1,0],
    [0,0,0,1,0,1,1,1,1,1,0,1,0,0,0],
    [0,1,1,1,0,1,0,1,0,1,0,1,1,1,0],
    [0,1,0,1,1,1,1,0,1,1,1,1,0,1,0],
    [0,1,1,1,0,0,1,1,1,0,0,1,1,1,0],
    [0,1,0,1,1,1,1,0,1,1,1,1,0,1,0],
    [1,1,0,0,1,0,1,0,1,0,1,0,0,1,0],
    [0,1,1,1,1,0,1,1,1,0,1,1,1,1,0],
    [0,0,0,0,0,0,0,0,0,0,0,0,0,0,0],
]